WWWWWWWWWWWWWWWWWWWW
W..................W
W....DDDDDDDD......W
W....D......D..TT..W
W....D..SS..D..TT..W
W....D..SS..D......W
W....D......D......W
W....DDDDDDDD......W
W..................W
W..TT......SSSS....W
W..TT......S..S....W
W..........SSSS....W
W..................W
W..................W
WWWWWWWWWWWWWWWWWWWW
